NO textures/bluestone.xpm
SO textures/eagle.xpm
WE textures/colorstone.xpm
EA textures/wood.xpm
F 255,255,0
C 0,255,255
        1111111111111111111111111
        1000000000110000000000001
        1011000001110000000000001
        1001000000000000000000001
111111111011000001110000000000001
10000000000000000111011111111111
11110111110111011100000010001
11110111110111011101010010001
11000000110101011100000000001
10000001000100001100000010001
10000000010001000001010010001
11000001110101011111011110N01
11110111 1110101 101111010001
11111111 1111111 111111111111
