R 640 480
NO textures/bluestone.xpm
SO textures/eagle.xpm
WE textures/redbrick.xpm
EA textures/mossy.xpm
S textures/barrel.xpm
F textures/wood.xpm
C textures/greystone.xpm
1111111111111111111111111
1110000000010100000000001
1000000000001000000001111
1110000000000000000001101
1100000000000000000001111
  1000000000000000000001111
1100000000000000000000001
1010000000000000000001101
1100000000000000000000001
1000000000000000000000001
1000000000000000000000001
1000000000000000000000001
1000000000000000000000001
1000000000000000000000001
10000000000S0000000000001
1000000000000000000000001
1000000000000000000000001
1000000000000000000000001
1000000000000000000000001
1000000000000000000000001
1000000000000000000000001
1100000100000100010000001
1010000000001010000000001
1111111111111111111111111
